11111111111111111111
10000000000001100001
10000000000000111101
10P0000000000000001
11111111111111111111