11111111111111111101
10000000000001100001
10000000000000111101
1000P000000000000001
11111111111111111111