111111111000000000000000000000
1P0000001111111111111111111111
11111111100000000000