11111111111111111111
10000000000001100001
10000000000P00111101
1000000000000000001
11111111111111111111