1111111111111111111111111111111
1000000000000000000000110000001
1000000000000000000000011110001
1P00000000000000000000000000001
1111111111111111111111111111111