1111111
1P0C1E1
1000011
1000001
1111111
