111111111111
100C0E010001
101C101000P1
100010C01001
100C000010C1
111111111111
