1111111
10C0C11
1C1C011
1PCC111
1E0CC11
1111111
