1111111
1000001
1PCE001
1111111