1111111
1001001
1PC0E01
1111111