1111111
1P0C1E1
10100C1
1111101
