111111111111
1CCCCCC1CCC1
1C1C1C1CCC11
10CC1CCC1C11
1E0CCCCC1CP1
111111111111
