111111111111
1P0C0E010001
101C10100001
100010C01001
100C000010C1
111111111111
