111111111111
1CCCCCC1CCC1
1C1C1C1CCC11
1CCC1CCC1C11
1ECCCCCC1CP1
111111111111
