111111
1PE1C1
101101
100001
111111
