111111
1P00C1
1E10C1
1CCCC1
111111