111111111
1PE010C01
11101C001
111111111