111111111
1PE010C01
1110C0011
111111111