111111111
1P00C0E11
111111111
